###########
#P      # #
####### # #
# K  O  D #
# # ### # #
# #  O  # #
# # ### # #
# # #   # #
# # ### # #
#       # #
###########